87
10 Guy : tenguy
Afraid to Ask Andy : afraid
An Older Code Sir, But It Checks Out : older
Ancient Aliens Guy : aag
At Least You Tried : tried
Baby Insanity Wolf : biw
Bad Luck Brian : blb
But That's None of My Business : kermit
Butthurt Dweller : bd
Captain Hindsight : ch
Comic Book Guy : cbg
Condescending Wonka : wonka
Confession Bear : cb
Conspiracy Keanu : keanu
Dating Site Murderer : dsm
Do It Live! : live
Do You Want Ants? : ants
Doge : doge
Drake Always On Beat : alwaysonbeat
Ermahgerd : ermg
First World Problems : fwp
Forever Alone : fa
Foul Bachelor Frog : fbf
Fuck Me, Right? : fmr
Futurama Fry : fry
Good Guy Greg : ggg
Hipster Barista : hipster
I Can Has Cheezburger? : icanhas
I Feel Like I'm Taking Crazy Pills : crazypills
I Guarantee It : mw
I Immediately Regret This Decision! : regret
I Should Buy a Boat Cat : boat
I Would Be So Happy : sohappy
I am the Captain Now : captain
Inigo Montoya : inigo
Insanity Wolf : iw
It's A Trap! : ackbar
It's Happening : happening
It's Simple, Kill the Batman : joker
Jony Ive Redesigns Things : ive
Laughing Lizard : ll
Matrix Morpheus : morpheus
Milk Was a Bad Choice : badchoice
Minor Mistake Marvin : mmm
Nothing To Do Here : jetpack
Oh, Is That What We're Going to Do Today? : red
One Does Not Simply Walk into Mordor : mordor
Oprah You Get a Car : oprah
Overlay Attached Girlfriend : oag
Pepperidge Farm Remembers : remembers
Philosoraptor : philosoraptor
Probably Not a Good Idea : jw
Sad Barack Obama : sad-obama
Sad Bill Clinton : sad-clinton
Sad Frog / Feels Bad Man : sadfrog
Sad George Bush : sad-bush
Sad Joe Biden : sad-biden
Sad John Boehner : sad-boehner
Sarcastic Bear : sarcasticbear
Schrute Facts : dwight
Scumbag Brain : sb
Scumbag Steve : ss
Sealed Fate : sf
See? Nobody Cares : dodgson
Shut Up and Take My Money! : money
So Hot Right Now : sohot
Socially Awesome Awkward Penguin : awesome-awkward
Socially Awesome Penguin : awesome
Socially Awkward Awesome Penguin : awkward-awesome
Socially Awkward Penguin : awkward
Stop Trying to Make Fetch Happen : fetch
Success Kid : success
Super Cool Ski Instructor : ski
That Would Be Great : officespace
The Most Interesting Man in the World : interesting
The Rent Is Too Damn High : toohigh
This is Bull, Shark : bs
Why Not Both? : both
Winter is coming : winter
X all the Y : xy
X, X Everywhere : buzz
Xzibit Yo Dawg : yodawg
Y U NO Guy : yuno
Y'all Got Any More of Them : yallgot
You Should Feel Bad : bad
You Sit on a Throne of Lies : elf
You Were the Chosen One! : chosen
